Month,Total Gym Rev,Total Dry Cleaner Rev,Real Rev,MonthlyCost,SBA.Loan
Jan,72000,18000,90000,699139,1000000
Feb,144000,19200,163200,147412,0
Mar,234000,24975,258975,147412,0
Apr,306000,24000,330000,147412,0
May,378000,24600,402600,147412,0
Jun,468000,33750,501750,147412,0
Jul,540000,28800,568800,147412,0
Aug,612000,29400,641400,147412,0
Sep,702000,41250,743250,147412,0
Oct,774000,36000,810000,147412,0
Nov,846000,39000,885000,147412,0
Dec,936000,49125,985125,147412,0
